14
20
60
1
60
2 2 2 2 2 2 2 2 2 2 2 2 2 2 2 2 2 2 2 2
2 4 1 0 4 1 0 4 1 0 4 1 0 4 1 0 4 1 0 3 
2 4 1 0 4 1 0 4 1 0 4 1 0 4 1 0 4 1 0 2 
2 4 1 0 4 1 0 4 1 0 4 1 0 4 1 0 4 1 0 2 
2 4 1 0 4 1 0 4 1 0 4 1 0 4 1 0 4 1 0 2 
2 4 1 0 4 1 0 4 1 0 4 1 0 4 1 0 4 1 0 2 
2 4 1 0 4 1 0 4 1 0 4 1 0 4 1 0 4 1 0 2 
2 4 1 0 4 1 0 4 1 0 4 1 0 4 1 0 4 1 0 2 
2 4 1 0 4 1 0 4 1 0 4 1 0 4 1 0 4 1 0 2 
2 4 1 0 4 1 0 4 1 0 4 1 0 4 1 0 4 1 0 2 
2 4 1 0 4 1 0 4 1 0 4 1 0 4 1 0 4 1 0 2 
2 0 0 0 0 0 0 0 0 0 0 0 0 0 0 0 0 0 0 2 
2 0 0 0 0 0 0 0 0 0 0 0 0 0 0 0 0 0 0 2 
2 2 2 2 2 2 2 2 2 2 2 2 2 2 2 2 2 2 2 2
1.0
1.5 
0.0 
0.7