11
12
1
1
0
2 2 2 2 2 2 2 2 2 2 2 2
3 0 0 0 0 0 0 2 2 0 0 2
2 0 0 0 0 0 2 2 0 0 0 2
2 0 0 0 0 2 2 0 0 0 0 2
2 0 0 0 2 2 1 0 0 0 0 2
2 0 0 2 2 0 0 0 0 0 0 2
2 0 2 2 0 0 0 0 0 0 0 2
2 0 2 0 0 0 0 0 0 0 0 2
2 0 0 0 0 0 0 0 0 0 0 2
2 0 0 0 0 0 0 0 0 0 0 2
2 2 2 2 2 2 2 2 2 2 2 2
1.0
1.5 
0.0 
0.0