17
20
49
1
51
2 3 2 2 2 2 2 2 2 2 2 2 2 2 2 2 2 2 2 2 
2 0 0 1 4 1 4 1 4 1 4 1 4 1 4 0 0 4 0 2 
2 0 0 0 0 0 0 0 0 0 0 0 0 0 0 0 0 4 1 2
2 0 0 1 4 1 4 1 4 1 4 1 4 1 4 0 0 4 0 2
2 0 0 0 0 0 0 0 0 0 0 0 0 0 0 0 0 0 0 2
2 0 0 1 4 1 4 1 4 1 4 1 4 1 4 0 0 0 0 2
2 0 0 0 0 0 0 0 0 0 0 0 0 0 0 0 0 0 0 2
2 0 0 1 4 1 4 1 4 1 4 1 4 1 4 0 0 0 0 2
2 0 0 0 0 0 0 0 0 0 0 0 0 0 0 0 0 0 0 2
2 0 0 1 4 1 4 1 4 1 4 1 4 1 4 0 0 0 0 2
2 0 0 0 0 0 0 0 0 0 0 0 0 0 0 0 0 0 0 2
2 0 0 1 4 1 4 1 4 1 4 1 4 1 4 0 0 0 0 2
2 0 0 0 0 0 0 0 0 0 0 0 0 0 0 0 0 0 0 2
2 0 0 1 4 1 4 1 4 1 4 1 4 1 4 0 0 0 0 2
2 0 0 0 0 0 0 0 0 0 0 0 0 0 0 0 0 0 0 2
2 0 0 1 4 1 4 1 4 1 4 1 4 1 4 0 0 0 0 2
2 2 2 2 2 2 2 2 2 2 2 2 2 2 2 2 2 2 2 2
1.0
1.5 
0.0 
0.7